NO ./ressources/111.xpm
SO ./ressources/222.xpm
WE ./ressources/333.xpm
EA ./ressources/444.xpm

F 117,89,82
C 46,192,240

11111
10001
 1N1
  1
