NO ./ressources/11.xpm
SO ./ressources/22.xpm
WE ./ressources/33.xpm
EA ./ressources/44.xpm

F 202,46,240
C 46,192,240

11111111111111111
10000000000000001
10000000000000001
10000000000000001
10000000000000001
10000010000000001
10000000000000001
10011100111110001
10000000000000001
10000000000000001
1000000N000000001
11111111111111111
